20 20
11100111111011110011
10000111111011110011
10100111111011110011
10000111111011110011
00100000000011110011
11100111111011110011
11100111111011110011
11100111111011110011
11100111111011110011
00000000000000000000
00000000000000000000
11100111111111110011
11100111111111110011
11100111111111110011
11100111111111110011
00000000000000000000
00000000000000000000
11100111111111110011
11100111111111110011
11100111111111110011