20 20
01011000100001111101
10010111010100101101
01110100111110100110
11111101111111001001
00011001110101101100
01001010110101110001
10110011111001101000
01100010100110001100
01010000000110001010
10010100101100001111
00010110001111011001
10110001011110000000
10001011100111010001
10101010001100011100
01001010110001111001
11001000100110010110
00000111110101101100
01111110111100101100
11110101110101011011
11100000110111100000